10 10
-1 -1 -1 -1 -1 -1 -1 -1 -1 -1
-1 -1 -1 -1 -1 -1 -1 -1 -1 -1
75 75 75 75 75 75 75 103 75 75
70 70 70 70 70 70 70 100 100 70
70 70 83 70 82 83 70 70 70 70
70 70 84 85 85 85 70 70 70 70
70 70 70 70 70 70 70 70 82 70
97 96 82 70 70 70 70 70 99 70
94 93 82 70 70 70 70 70 82 70
70 70 70 70 70 70 70 70 70 70