10 10
75 103 103 75 75 76 76 76 75 75
70 70 70 70 70 76 76 76 100 101
70 70 70 70 70 75 75 75 70 102
82 82 70 70 83 70 82 70 70 70
97 96 82 70 84 85 85 85 70 70
91 92 82 70 70 70 70 70 70 70
91 92 82 70 70 70 70 70 82 70
94 93 82 70 70 70 70 70 99 70
82 82 70 70 70 70 70 70 82 70
76 76 76 70 70 70 76 76 76 76