16 20
2 2 2 2 2 2 2 2 2 2 39 37 36 44 2 2
17 2 2 3 2 2 2 0 0 2 40 47 42 41 2 2
2 2 3 2 3 3 2 17 2 3 46 38 45 43 2 0
7 7 7 2 3 2 3 3 0 2 27 27 27 30 2 2
7 7 7 2 17 2 17 2 2 29 26 35 26 26 2 2
2 28 3 2 2 2 2 2 2 2 9 32 10 0 2 2
2 28 2 17 0 2 17 2 2 9 32 32 10 2 17 2
2 2 0 2 2 2 0 2 29 9 32 32 10 2 0 2
2 17 2 2 17 1 3 2 9 32 32 10 2 2 0 0
0 2 0 2 2 2 17 2 9 32 33 10 17 17 2 2
0 39 37 36 44 0 0 9 32 32 10 2 2 2 17 2
2 40 47 42 41 2 2 9 33 33 10 0 2 0 2 0
2 46 38 45 43 0 0 9 32 32 10 2 0 2 0 2
1 27 27 27 27 0 17 9 33 32 10 29 2 2 2 2
2 26 26 26 31 0 2 9 32 32 10 0 17 2 2 2
29 26 35 26 26 29 0 9 32 10 0 3 3 2 2 0
0 9 33 3 17 1 29 9 33 10 29 2 17 2 1 2
2 9 32 11 11 11 32 33 32 10 3 2 2 2 2 2
17 9 33 32 33 32 32 3 1 2 3 2 3 3 1 2
0 3 8 8 8 8 8 3 2 2 17 0 2 2 2 2