16 20
2 2 44 46 45 2 2 2 2 2 58 56 55 63 2 2
17 2 41 39 40 2 2 2 2 2 59 66 61 60 2 2
2 2 42 48 43 2 2 1 2 3 65 57 64 62 2 0
1 2 2 38 3 2 2 2 2 3 37 37 37 37 17 2
2 58 56 55 63 2 17 3 2 17 36 36 51 51 2 2
2 59 66 61 60 2 44 47 45 49 36 54 36 36 49 2
2 65 57 64 62 2 41 39 40 2 9 53 10 2 17 2
2 37 37 37 37 2 42 48 43 2 9 52 10 2 0 2
2 36 36 36 50 2 2 38 2 23 22 53 10 2 0 0
49 36 54 36 36 49 17 2 2 9 53 19 20 17 2 2
2 9 52 18 11 11 11 11 11 22 53 10 2 2 17 2
2 9 52 53 53 53 53 53 53 53 53 10 2 1 2 0
2 21 8 8 8 8 8 8 8 9 53 10 2 2 0 2
17 58 56 55 63 2 17 2 2 9 53 10 2 2 2 2
3 59 66 61 60 23 11 11 11 22 53 10 1 2 2 1
2 65 57 64 62 9 52 52 53 52 53 10 2 3 2 0
17 37 37 37 37 9 53 19 8 8 8 20 3 2 1 2
49 36 36 54 36 22 53 10 2 1 2 2 25 15 15 15
2 2 9 53 52 53 53 10 2 2 3 25 26 7 6 7
2 3 21 8 8 8 8 20 2 2 17 14 16 6 16 5