16 20
2 2 2 47 50 48 2 2 2 2 61 59 58 66 2 2
17 2 2 44 42 43 2 2 2 2 62 69 64 63 2 2
2 2 2 45 51 46 2 1 2 3 68 60 67 65 2 0
1 2 2 2 41 2 2 2 2 3 40 40 40 40 17 2
2 61 59 58 66 2 47 50 48 17 39 39 54 54 2 2
2 62 69 64 63 2 44 42 43 52 39 57 39 39 52 2
2 68 60 67 65 2 45 51 46 2 9 56 10 2 17 2
2 40 40 40 40 2 3 41 2 2 9 56 10 17 0 2
2 39 39 39 53 2 2 2 1 24 23 56 10 17 2 0
52 39 57 39 39 52 0 2 2 9 56 19 21 17 2 2
2 9 56 18 11 11 11 11 11 23 56 10 2 2 17 2
2 9 56 56 56 56 56 56 56 56 56 10 2 1 2 0
2 22 8 8 8 8 8 8 8 20 56 10 2 2 0 2
17 61 59 58 66 2 17 2 2 9 56 10 2 2 2 2
3 62 69 64 63 24 11 11 11 23 56 10 1 2 2 1
2 68 60 67 65 9 56 56 56 56 56 10 2 3 2 0
2 40 40 40 40 9 56 19 8 8 8 21 3 2 1 2
52 39 57 39 39 23 56 10 2 1 2 2 17 26 15 15
2 9 56 56 56 56 56 10 2 2 3 26 15 28 6 6
2 22 8 8 8 8 8 21 2 2 17 14 16 6 16 5