17 13
17 2 2 59 66 61 60 2 2 3 2 2 2 2 2 2 2
2 2 3 65 57 64 62 2 3 2 2 2 2 2 2 2 2
3 2 17 37 37 37 37 2 17 1 2 2 2 2 2 2 2
17 2 0 36 36 51 51 17 2 2 2 2 2 2 2 2 2
2 17 49 36 54 36 36 49 1 2 2 2 2 2 2 2 2
2 2 3 9 53 10 17 3 2 2 2 2 2 0 0 0 0
2 2 17 9 52 10 2 2 2 2 2 2 1 2 2 2 2
2 3 2 9 52 10 3 2 3 3 3 3 3 3 2 2 2
2 2 2 9 53 10 2 3 2 2 2 2 2 2 0 0 0
2 2 2 1 2 2 2 2 2 2 2 2 2 2 0 0 0
2 2 1 1 2 2 2 2 2 2 2 2 2 2 0 0 0
2 2 2 2 2 2 2 0 2 2 2 2 2 2 0 0 0
2 2 1 2 1 2 0 2 2 2 0 0 2 0 0 0 0