17 13
17 2 2 40 47 42 41 2 2 3 3 3 3 3 12 12 13
2 2 3 46 38 45 43 2 3 2 2 2 3 3 13 12 12
3 2 17 27 27 27 27 2 2 2 2 3 2 3 12 12 12
17 2 3 26 26 26 30 17 2 2 2 2 2 0 0 0 0
2 1 29 26 35 26 26 29 1 2 2 2 2 2 0 0 0
2 2 2 9 32 10 2 3 2 2 2 2 2 0 0 0 0
2 0 9 33 33 10 2 2 2 2 2 2 1 2 2 2 2
2 9 32 32 33 10 3 3 3 3 3 3 3 3 2 2 2
2 2 2 32 32 10 2 3 2 2 2 2 2 2 0 0 0
2 2 2 1 2 2 2 2 2 2 2 2 2 2 0 0 0
2 2 1 1 2 2 2 2 2 2 2 2 2 2 0 0 0
2 2 2 2 2 2 2 0 2 2 2 2 2 2 0 0 0
2 2 1 2 1 2 0 2 2 2 0 0 2 0 0 0 0