17 13
12 13 12 12 12 12 13 12 12 12 12 13 12 12 12 12 13
12 12 12 13 12 12 12 12 13 12 12 12 12 12 13 12 12
12 12 12 12 12 12 12 12 12 12 12 12 12 12 12 12 12
0 10 10 10 10 0 0 2 2 0 0 0 0 0 0 0 0
0 10 10 10 10 0 0 2 2 0 0 0 0 0 0 0 0
0 0 2 2 0 0 0 2 2 0 0 0 0 0 0 0 0
0 0 2 2 2 2 2 2 2 2 2 2 2 2 2 2 2
0 0 2 2 2 2 2 2 2 2 2 2 2 2 2 2 2
0 0 0 0 0 0 0 2 2 0 0 9 9 9 0 0 0
9 9 9 0 2 2 2 2 2 0 0 9 9 9 0 0 0
9 9 9 0 2 2 2 2 2 0 0 0 7 0 0 0 0
0 7 0 0 2 2 0 0 0 0 0 0 7 0 0 0 0
0 7 0 0 2 2 0 0 0 0 0 0 0 0 0 0 0