17 13
17 2 2 62 69 64 63 2 2 3 2 2 2 2 2 2 2
2 2 3 68 60 67 65 2 3 2 2 2 2 2 2 2 2
3 2 17 40 40 40 40 2 17 1 2 2 2 2 2 2 2
17 2 0 39 39 54 54 17 2 2 2 2 2 2 2 2 2
2 1 52 39 57 39 39 52 1 2 2 2 2 2 2 2 2
2 2 3 9 55 10 17 3 2 2 2 2 2 0 0 0 0
2 2 17 9 56 10 2 2 2 2 2 2 1 2 2 2 2
2 3 2 9 55 10 3 2 3 3 3 3 3 3 2 2 2
2 2 2 9 56 10 2 3 2 2 2 2 2 2 0 0 0
2 2 2 1 2 2 2 2 2 2 2 2 2 2 0 0 0
2 2 1 1 2 2 2 2 2 2 2 2 2 2 0 0 0
2 2 2 2 2 2 2 0 2 2 2 2 2 2 0 0 0
2 2 1 2 1 2 0 2 2 2 0 0 2 0 0 0 0